111111111111111111
100000000000000C01
101001010010000011
101001001010101001
1P0000000C00C000E1
111111111111111111
